##########
#   ##   #
#        #
#        #
#  #  #  #
#     #  #
#   ###  #
#        #
#        #
##########